11111111111111111111111
11111111111111111111111
10000000000000000000001
10000000000000000000001
10000001111111111110001
10000111000000000010001
10000100000111111111001
10000100000100000001001
10111100000100000001001
10100100000100000001001
10100100000111111111001
10100100000000000010001
10100100000000000010001
10100100000000000010001
10100100000000000010001
10100100000000000010001
10111100000000000010001
10000100011111100010001
10000100010000100010001
1000010001E000100010001
10000100010000100010001
10000111110000111110001
10000000000000000000001
100000000000C00P0000001
11111111111111111111111
