1111111111111111111111111111111111
1111111111111111111111111111111111
11P00000000000000000000000C1111111
1111111111111111111111111011111111
11111C1111111111111111111011111111
1111111111111111111111111011111111
1111111111111111111111111011111111
1111111111111111111111111011111111
111111111C111111111111111011111111
1111111111111111111111111011111111
1111111111111111111111111011111111
1111111111111111111111111011111111
1111111111111111111C11111011111111
1111111111111111111111111011111111
1111111111111111111111111011111111
11111111111111111111111110111C1111
1111111111111111111111111011111111
1111111C11111111111111111000000E11
1111111111111111111111111111111111
1111111111111111111111111111111111