1111111111111111111111111111111111
1111111111111111111111111111111111
11P11111111111111111111111C1111111
1111111111111111111111111111111111
11111C1111111111111111111111111111
1111111111111111111111111111111111
1111111111111111111111111111111111
1111111111111111111111111111111111
111111111C111111111111111111111111
1111111111111111111111111111111111
1111111111111111111111111111111111
1111111111111111111111111111111111
1111111111111111111C11111111111111
1111111111111111111111111111111111
1111111111111111111111111111111111
11111111111111111111111111111C1111
1111111111111111111111111111111111
1111111C11111111111111111111111E11
1111111111111111111111111111111111
1111111111111111111111111111111111