1111111111111
1001000000000
1000010000001
1PPC010000001
1111111111111111111