111111111111111111
1P00E00000C0000001
111111111111111111