1111111111111111111111111111111111
1E0000000000000C000N0C000000000001
10100101001000001010010N0000010101
1010N1001010101N001001000N00010101
1P00000N0C00C00000000000000N0000C1
1111111111111111111111111111111111