11111111111
11110C01111
11110001111
11110N01111
11110001111
10000000001
1C0N0P0N0E1
10000000001
11110N01111
11110001111
11110C01111
11111111111