1111111111111
10C1000N000C1
100001000C001
1P0C01E000001
11111111F1111
110110100C111
1101101111011
1110001000011
1111101011111
1111101100011
1111111111111
1111111111111