11111111111
1P000N000E1
10110001101
1010C000101
10000100001
10001110001
10N00100N01
10100N00101
1C110001101
100000C0001
11111111111