11111111111111
1PCE1111111111
11111111111111