11111111111111111111111111111
1P0000000000000C10000000000E1
10000000000000011000000010001
10000000000000010000000010001
10000000000000010000000010001
10000000000000C10000000010001
1000000000000111000000001C001
10000000000000000000000011111
111111000000000000000000000C1
1CCN0000000000000000000011N11
1CC00N00000000000000000000101
11111111111111111111111111111